BaseRandom.cs        	产生随机数 
CookieHelper.cs        	写cookie
DangerousString.cs     	过滤在线编辑器中的危险字符串
DotNetCacheManager.cs	生成缓存项
EmailHelper.cs	        发邮件
DateHelper.cs	        时间类
Encrypt.cs	            字符串加密组件
TypeParse.cs	        类型转换类
EnumHelper.cs	        枚举操作类
ErrorHelper.cs	        异常信息处理类
FileHelper.cs	        文件帮助类
FileUploadHelper.cs	    上传文件操作类
GDIHelper.cs	        图形处理类
GDI.cs	                图片设置类
INIFile.cs	            INI文件读写类
JsonHelper.cs	        json串操作类
MD5.cs	                加密类
Pager.cs	            分页
MVCPager.cs	            分页
PageValidate.cs	        页面数据校验类
PubConstant.cs	        数据库连接类
PublicSqlData.cs	    数据分页
SendSMS.cs	            短信发送类
QRCodeHelper.cs	        企汇网二维码生成类
SqlHelper.cs	        sql操作类
SqlHelperParameterCache.cs	
StringHelper.cs	        字符串操作类
WeiBoTypeEnum.cs	    微博的类型
XMLSerializer.cs	    xml操作类
MongoDBHelper.cs	    MongoDB数据库操作类
QRCode					二维码生成操作类